10 10
0 0
0 0 0 0 0 0 0 0 0 0
4 6 0 0 0 0 0 0 0 0
0 0 0 0 0 0 0 0 0 0
0 4 6 0 0 0 0 0 0 0
0 0 0 9 8 0 0 0 0 0
0 0 4 5 6 0 0 0 0 0
0 0 0 9 0 0 0 0 0 0
0 0 0 4 5 6 0 0 0 0
0 8 0 0 9 0 0 9 0 0
1 2 2 2 2 2 2 2 2 3